报告编号=检验信息_报告书编号
检验类型=检验信息_检验目的/任务类别
委托日期=检验信息_样品到达日期
样品名称br=抽检样品信息_样品名称
规格型号=抽检样品信息_规格型号
样品数=抽检样品信息_抽样数量
样品等级=抽检样品信息_质量等级
样品类型=抽检样品信息_样品类型
生产日期=抽检样品信息_生产日期
保存条件=抽检样品信息_抽样时样品储存条件
商标=抽检样品信息_样品商标
生产批号=抽检样品信息_生产日期
保质期=抽检样品信息_保质期
样品状态3=抽检样品信息_包装分类
业务受理人=检验信息_检查封样人员
委托单位=抽样基础信息_任务来源
受检单位=抽检场所信息_单位名称
地址=抽检场所信息_单位地址
联系人=抽检场所信息_单位法人
电话=抽检场所信息_联系人电话
生产单位=生产企业信息_企业名称
生产单位地址=生产企业信息_企业地址
生产单位联系人=生产企业信息_联系人
生产单位电话=生产企业信息_电话
检验依据=抽检样品信息_执行标准/技术文件
抽样单号=抽样基础信息_抽样单编号
抽送样人=抽样单位信息_抽样人员
抽样方式=抽检样品信息_抽样方式
抽样地点=抽检场所信息_抽样地点
抽样基数=抽检样品信息_抽样基数
抽到样日期=抽检样品信息_抽样日期
备注=抽检样品信息_备注
检验结论=检验结论
状态=状态